Jason's Coming
An Interactive Fiction by Nichtschwert
Release 1 / Serial number 220129 / Inform 7 build 6M62 (I6/v6.33 lib 6/12N) SD

gravity control room
You have locked yourself inside the gravity control room because Jason is coming to murder you. He's breaking down the door right now. Quick! Think of something!

The door to the east is locked. There's nothing but Jason through there.

Affixed to the west wall is a sturdy security case with a lock on it.

A plain-looking desk of dark wood stands in the northeastern corner. It has two drawers.

On the desk are a loaded gun and an apple.

A lever on the southern wall is labelled "gravity control".

>wait
Time passes.

Jason is beating down the door, but it holds yet.

>wait
Time passes.

You can hear Jason beating down the door.

>wait
Time passes.

You can hear Jason beating down the door.

>wait
Time passes.

Jason continues to beat down the door. It's really starting to come apart.

>wait
Time passes.

You can hear Jason beating down the door.

>wait
Time passes.

Jason's still hammering away at the door. It's very nearly broken.

>wait
Time passes.

The door breaks down and is flung into the room. Jason is here!

>shoot Jason
(first taking the loaded gun)
You shoot Jason and he falls over.

    *** You killed him. Rude. ***

Would you like to RESTART, RESTORE a saved game, QUIT or UNDO the last command?

* * *

>look door
You see nothing special about the wooden door.

Jason is beating down the door, but it holds yet.

>look
gravity control room
You have locked yourself inside the gravity control room because Jason is coming to murder you. he's breaking down the door right now. Quick! Think of something!

The door to the east is locked. There's nothing but Jason through there.

Jason continues to beat down the door. It's really starting to come apart.

>i
You are carrying nothing.

Jason's still hammering away at the door. It's very nearly broken.

>look
gravity control room
You have locked yourself inside the gravity control room because Jason is coming to murder you. he's breaking down the door right now. Quick! Think of something!

The door to the east is locked. There's nothing but Jason through there.

The door breaks down and is flung into the room. Jason is here!

>look
gravity control room
You have locked yourself inside the gravity control room because Jason is coming to murder you. he's breaking down the door right now. Quick! Think of something!

The door to the east is locked. There's nothing but Jason through there.

You can also see Jason here.

>x jason
Oh god oh fuck it's Jason!

* * *

>e
(first opening the wooden door)
It seems to be locked.

Jason is beating down the door, but it holds yet.

>w
You can't go that way.

Jason continues to beat down the door. It's really starting to come apart.

>i
You are carrying nothing.

Jason's still hammering away at the door. It's very nearly broken.

* * *

>look
gravity control room
You have locked yourself inside the gravity control room because Jason is coming to murder you. he's breaking down the door right now. Quick! Think of something!

The door to the east is locked. There's nothing but Jason through there.

The door breaks down and is flung into the room. Jason is here!

>x Jason
Oh god oh fuck it's Jason!

>x door
You see nothing special about the wooden door.

>w
You can't go that way.

>e
(first opening the wooden door)
It seems to be locked.

>s
You can't go that way.

>x jason
Oh god oh fuck it's Jason!

* * *

>e
(first opening the wooden door)
It seems to be locked.

Jason is beating down the door, but it holds yet.

>e
(first opening the wooden door)
It seems to be locked.

Jason continues to beat down the door. It's really starting to come apart.

>e
(first opening the wooden door)
It seems to be locked.

Jason's still hammering away at the door. It's very nearly broken.

>e
(first opening the wooden door)
It seems to be locked.

The door breaks down and is flung into the room. Jason is here!

>e
(first opening the wooden door)
It seems to be locked.

Jason walks over and hits you with his machete and you die.

    *** The End ***

Would you like to RESTART, RESTORE a saved game, QUIT or UNDO the last command?

>restart
Jason's Coming
An Interactive Fiction by Nichtschwert
Release 1 / Serial number 220129 / Inform 7 build 6M62 (I6/v6.33 lib 6/12N) SD

gravity control room
You have locked yourself inside the gravity control room because Jason is coming to murder you. he's breaking down the door right now. Quick! Think of something!

The door to the east is locked. There's nothing but Jason through there.

>e
(first opening the wooden door)
It seems to be locked.

Jason is beating down the door, but it holds yet.

* * *

>e
(first opening the wooden door)
It seems to be locked.

The door breaks down and is flung into the room. Jason is here!

>x Jason
Oh god oh fuck it's Jason!

Jason walks over and hits you with his machete and you die.

    *** The End ***

Would you like to RESTART, RESTORE a saved game, QUIT or UNDO the last command?

>restart
Jason's Coming
An Interactive Fiction by Nichtschwert
Release 1 / Serial number 220129 / Inform 7 build 6M62 (I6/v6.33 lib 6/12N) SD

gravity control room
You have locked yourself inside the gravity control room because Jason is coming to murder you. he's breaking down the door right now. Quick! Think of something!

The door to the east is locked. There's nothing but Jason through there.

* * *

>x case
In the security case is a glass bottle.

>get case
That's fixed in place.

Jason is beating down the door, but it holds yet.

* * *

>get desk
That's fixed in place.

Jason is beating down the door, but it holds yet.

>get gun
Taken.

Jason continues to beat down the door. It's really starting to come apart.

>wait
Time passes.

Jason's still hammering away at the door. It's very nearly broken.

* * *

>wait
Time passes.

The door breaks down and is flung into the room. Jason is here!

>shoot Jason
That's not a verb I recognise.

* * *

>shoot case with pistol
You can't see any such thing.

>shoot case with gun
(first taking the security case)
That's fixed in place.

Jason is beating down the door, but it holds yet.

>shoot gun with case
(first taking the loaded gun)
You put a couple holes in the loaded gun.

Jason continues to beat down the door. It's really starting to come apart.

* * *

>shoot case with gun
(first taking the loaded gun)
You put a couple holes in the security case.

Jason is beating down the door, but it holds yet.

>shoot door with gun
You put a couple holes in the wooden door.

Jason continues to beat down the door. It's really starting to come apart.

>shoot gun with gun
You put a couple holes in the loaded gun.

Jason's still hammering away at the door. It's very nearly broken.

>shoot me with gun
You put a couple holes in yourself.

The door breaks down and is flung into the room. Jason is here!

>shoot self at jason
(first taking yourself)
You are always self-possessed.

Jason walks over and hits you with his machete and you die.

    *** The End ***

Would you like to RESTART, RESTORE a saved game, QUIT or UNDO the last command?

>restart
Jason's Coming
An Interactive Fiction by Nichtschwert
Release 1 / Serial number 220129 / Inform 7 build 6M62 (I6/v6.33 lib 6/12N) SD

gravity control room
You have locked yourself inside the gravity control room because Jason is coming to murder you. he's breaking down the door right now. Quick! Think of something!

The door to the east is locked. There's nothing but Jason through there.

Affixed to the west wall is a sturdy security case with a lock on it.

You can also see a desk (on which is a loaded gun) here.

* * *

>shoot desk with apple
(first taking the apple)
You put a couple holes in the desk.

Jason is beating down the door, but it holds yet.

* * *

>shoot self with apple
(first taking the apple)
You make pew pew noises while waving yourself around. This impresses nobody.

You put a couple holes in yourself.

Jason is beating down the door, but it holds yet.

* * *

>shoot self with apple.
(first taking the apple)
You make pew pew noises while waving the apple around. This impresses nobody.

You put a couple holes in yourself.

Jason is beating down the door, but it holds yet.

>shoot self with gun
(first taking the loaded gun)
You put a couple holes in yourself.

Jason continues to beat down the door. It's really starting to come apart.

>drop firearm
You can't see any such thing.

* * *

>shoot self with gun
(first taking the loaded gun)
You put a couple holes in yourself to little avail.

Jason is beating down the door, but it holds yet.

>shoot self with apple
(first taking the apple)
You put a couple holes in yourself to little avail.

Jason continues to beat down the door. It's really starting to come apart.

>shoot gun with gun
You put a couple holes in the loaded gun to little avail.

Jason's still hammering away at the door. It's very nearly broken.

* * *

>shoot self with gun
(first taking the loaded gun)
You put a couple holes in yourself to little avail.

Jason is beating down the door, but it holds yet.

>shoot gun with apple
(first taking the apple)
You make pew pew noises while waving the apple around. This impresses nobody.

Jason continues to beat down the door. It's really starting to come apart.

>shoot gun with gun
The logistics of this mystify me. Try something else!

You put a couple holes in the loaded gun to little avail.

Jason's still hammering away at the door. It's very nearly broken.

>shoot jason with gun
You can't see any such thing.

>fire gun at apple
You put a couple holes in the apple to little avail.

The door breaks down and is flung into the room. Jason is here!

* * *

>shoot self
(first taking the loaded gun)
Sure.

    *** The End ***

Would you like to RESTART, RESTORE a saved game, QUIT or UNDO the last command?

>shoot apple
You put a couple holes in the apple to little avail.

Jason continues to beat down the door. It's really starting to come apart.

* * *

>shoot self
(first taking the loaded gun)
Sure.

    *** The End ***

Would you like to RESTART, RESTORE a saved game, QUIT or UNDO the last command?

>restart
Jason's Coming
An Interactive Fiction by Nichtschwert
Release 1 / Serial number 220129 / Inform 7 build 6M62 (I6/v6.33 lib 6/12N) SD

gravity control room
You have locked yourself inside the gravity control room because Jason is coming to murder you. he's breaking down the door right now. Quick! Think of something!

The door to the east is locked. There's nothing but Jason through there.

Affixed to the west wall is a sturdy security case with a lock on it.

A plain-looking desk of dark wood stands in the northeastern corner. It has two drawers.

On the desk are a loaded gun and an apple.

>shoot case
(first taking the loaded gun)
You put a couple holes in the security case to little avail.

Jason is beating down the door, but it holds yet.

* * *

>shoot door
(first taking the loaded gun)
You fire at the wooden door, punching big holes into it and showering the room with splinters. Was this a good idea?

The door breaks down and is flung into the room. Jason is here!

>shoot self
With lightning speed Jason is on top of you, wrenching the gun from your hand. You burst into tears and Jason kneels down to embrace you. He tells you it's okay. it#s okay to cry and you cry into his shoulder. Jason listens to your problems for a full hour and gives you a handkerchief when you need one. Then he gives you the number of a therapist he trusts. He also gives you his number and tells you to call him whenever you need some help.

    *** Good End ***

Would you like to RESTART, RESTORE a saved game, QUIT or UNDO the last command?

>undo
gravity control room
[Previous turn undone.]

>give gun to jason
Jason doesn't seem interested.

Jason walks over and he hits you with his machete and you die.

    *** The End ***

Would you like to RESTART, RESTORE a saved game, QUIT or UNDO the last command?

* * *

>take apple
Taken.

Jason is beating down the door, but it holds yet.

>shoot apple
Dropped.

(first taking the loaded gun)
You put a couple holes in the apple to little avail.

Jason continues to beat down the door. It's really starting to come apart.

* * *

>get apple
Taken.

Jason is beating down the door, but it holds yet.

>shoot apple
(first dropping the apple)
(first taking the loaded gun)
You put a couple holes in the apple to little avail.

Jason continues to beat down the door. It's really starting to come apart.

* * *

>shoot door
(first taking the loaded gun)
You fire at the wooden door, punching big holes into it and showering the room with splinters. Was this a good idea?

The door breaks down and is flung into the room. Jason is here!

>shoot door
You send a couple bullets down the hallway. I'm sure Frank in accounting appreciates it.

Jason walks over and hits you with his machete and you die.

    *** The End ***

Would you like to RESTART, RESTORE a saved game, QUIT or UNDO the last command?

>restart
Jason's Coming
An Interactive Fiction by Nichtschwert
Release 1 / Serial number 220129 / Inform 7 build 6M62 (I6/v6.33 lib 6/12N) SD

gravity control room
You have locked yourself inside the gravity control room because Jason is coming to murder you. he's breaking down the door right now. Quick! Think of something!

The door to the east is locked. There's nothing but Jason through there.

Affixed to the west wall is a sturdy security case with a lock on it.

You can also see a desk (on which are a loaded gun and an apple) here.

>east
(first opening the wooden door)
It seems to be locked.

Jason is beating down the door, but it holds yet.

>shoot door
(first taking the loaded gun)
You fire at the wooden door, punching big holes into it and showering the room with splinters. Was this a good idea?

The door breaks down and is flung into the room. Jason is here!

>east
(first opening the wooden door)
It seems to be locked.

Jason walks over and hits you with his machete and you die.

    *** The End ***

Would you like to RESTART, RESTORE a saved game, QUIT or UNDO the last command?

* * *

>shoot door
(first taking the loaded gun)
You fire at the wooden door, punching big holes into it and showering the room with splinters. Was this a good idea?

The door breaks down and is flung into the room. Jason is here!

>east
You can't, since the wooden door leads nowhere.

Jason walks over and hits you with his machete and you die.

    *** The End ***

Would you like to RESTART, RESTORE a saved game, QUIT or UNDO the last command?

* * *

>shoot door
(first taking the loaded gun)
You fire at the wooden door, punching big holes into it and showering the room with splinters. Was this a good idea?

The door breaks down and is flung into the room. Jason is here!

>e
hallway
Little is left of the door. Could probably just walk on through.

And you walk out. You just walk out.

    *** You have escaped. ***

Would you like to RESTART, RESTORE a saved game, QUIT or UNDO the last command?

>undo
gravity control room
[Previous turn undone.]

>go through door
hallway
Little is left of the door. Could probably just walk on through.

    *** And you walk out. You just walk out. ***

Would you like to RESTART, RESTORE a saved game, QUIT or UNDO the last command?

>undo
gravity control room
[Previous turn undone.]

>exit
But you aren't in anything at the moment.

Jason walks over and hits you with his machete and you die.

    *** The End ***

Would you like to RESTART, RESTORE a saved game, QUIT or UNDO the last command?

>undo
gravity control room
[Previous turn undone.]

>leave
But you aren't in anything at the moment.

Jason walks over and hits you with his machete and you die.

    *** The End ***

Would you like to RESTART, RESTORE a saved game, QUIT or UNDO the last command?

* * *

>undo
gravity control room
[Previous turn undone.]

>shoot jason
You shoot Jason and he falls over.

    *** You killed him. Rude. ***

Would you like to RESTART, RESTORE a saved game, QUIT or UNDO the last command?

* * *

>shoot door
(first taking the loaded gun)
You fire at the wooden door, punching big holes into it and showering the room with splinters. Was this a good idea?

The door breaks down and is flung into the room. Jason is here!

>shoot Jason
You shoot Jason and he falls over.

    *** The End ***

Would you like to RESTART, RESTORE a saved game, QUIT or UNDO the last command?

* * *

>shoot door
(first taking the loaded gun)
You fire at the wooden door, punching big holes into it and showering the room with splinters. Was this a good idea?

The door breaks down and is flung into the room. Jason is here!

>look
gravity control room
You have locked yourself inside the gravity control room because Jason is coming to murder you. he's breaking down the door right now. Quick! Think of something!

Jason is coming at you with his machete!

Little is left of the door. Could probably just walk on through.

Affixed to the west wall is a sturdy security case with a lock on it.

You can also see a glass bottle and a desk (on which is an apple) here.

* * *

>shoot door
(first taking the loaded gun)
You fire at the wooden door, punching big holes into it and showering the room with splinters. Was this a good idea?

The door breaks down and is flung into the room. Jason is here!

>turn off gravity
You flip the lever and suddenly feel very light. You accidentlaly kick yourself off the floor and bump into the ceiling.
The glass bottle starts floating about ominously. This is not safe.

Jason floats over and he hits you with his machete and you die.

    *** The End ***

Would you like to RESTART, RESTORE a saved game, QUIT or UNDO the last command?

>undo
gravity control room
[Previous turn undone.]

>undo
gravity control room
[Previous turn undone.]

>shoot door
(first taking the loaded gun)
You fire at the wooden door, punching big holes into it and showering the room with splinters. Was this a good idea?

The door breaks down and is flung into the room. Jason is here!

>wait
Time passes.

Jason walks over and he hits you with his machete and you die.

    *** The End ***

Would you like to RESTART, RESTORE a saved game, QUIT or UNDO the last command?

>undo
gravity control room
[Previous turn undone.]

>turn off gravity
You flip the lever and suddenly feel very light. You accidentlaly kick yourself off the floor and bump into the ceiling.
 Jason continues banging on the door. Seems the gravity control only affects this room. very curious.
The glass bottle starts floating about ominously. This is not safe.

Jason is beating down the door, but it holds yet.
Yup. Jason's still at it. Will break through any minute now.

>shoot door
(first taking the loaded gun)
You fire at the wooden door, punching big holes into it and showering the room with splinters. Was this a good idea?

The door breaks down and is flung into the room. Jason is here!
He looks a bit perplexed as he lifts off the ground entering the room. But he's been in space before. This will not stop him!

>turn gravity on
You struggle to flip the lever, but finally manage. Gravity returns much more suddenly than expected and your fall to the floor, landing painfully on your left shoulder.
The glass bottle falls to the floor and shatters into a thousand pieces. This is EXACTLY why we have that security case!

Jason walks over, glass shards cracking under his boots, and he hits you with his machete and you die.

    *** The End ***

Would you like to RESTART, RESTORE a saved game, QUIT or UNDO the last command?

* * *

>shoot door
(first taking the loaded gun)
You fire at the wooden door, punching big holes into it and showering the room with splinters. Was this a good idea?

The door breaks down and is flung into the room. Jason is here!

>shoot jason
You shoot Jason and he falls over.

    *** You killed him. Rude. ***

Would you like to RESTART, RESTORE a saved game, QUIT or UNDO the last command?

* * *

>shoot door
(first taking the loaded gun)
You fire at the wooden door, punching big holes into it and showering the room with splinters. Was this a good idea?

The door breaks down and is flung into the room. Jason is here!

>give gun to Jason
You offer the loaded gun to Jason and he hesitates. He gingerly takes it out of your hand and then awkwardly hands you his machete. It is very heavy and you almost drop it. Jason silently nods at you and turns to leave. Before walking out the door he turns and flashes the peace sign. Then he is gone.

    *** Nice knife you got there ***

Would you like to RESTART, RESTORE a saved game, QUIT or UNDO the last command?

>undo
gravity control room
[Previous turn undone.]

>give Jason to jason
(first taking Jason)
I don't suppose Jason would care for that.

Jason walks over and he hits you with his machete and you die.

    *** The End ***

Would you like to RESTART, RESTORE a saved game, QUIT or UNDO the last command?

>undo
gravity control room
[Previous turn undone.]

>give desk to jason
(first taking the desk)
That's fixed in place.

Jason walks over and he hits you with his machete and you die.

    *** The End ***

Would you like to RESTART, RESTORE a saved game, QUIT or UNDO the last command?

>restart
Jason's Coming
An Interactive Fiction by Nichtschwert
Release 1 / Serial number 220129 / Inform 7 build 6M62 (I6/v6.33 lib 6/12N) SD

gravity control room
You have locked yourself inside the gravity control room because Jason is coming to murder you. he's breaking down the door right now. Quick! Think of something!

The door to the east is locked. There's nothing but Jason through there.

Affixed to the west wall is a sturdy security case with a lock on it.

A plain-looking desk of dark wood stands in the northeastern corner. It has two drawers.

On the desk are a loaded gun and an apple.

>open upper drawer
You open the upper drawer, revealing a small key.

Jason is beating down the door, but it holds yet.

>shoot door
(first taking the loaded gun)
You fire at the wooden door, punching big holes into it and showering the room with splinters. Was this a good idea?

The door breaks down and is flung into the room. Jason is here!

>give key to jason
(first taking the small key)
You offer the small key to Jason and he hesitates. He gingerly takes it out of your hand and then awkwardly hands you his machete. It is very heavy and you almost drop it. Jason silently nods at you and turns to leave. Before walking out the door he turns and flashes the peace sign. Then he is gone.

    *** Nice knife you got there ***

Would you like to RESTART, RESTORE a saved game, QUIT or UNDO the last command?

* * *

>shoot door
(first taking the loaded gun)
You fire at the wooden door, punching big holes into it and showering the room with splinters. Was this a good idea?

The door breaks down and is flung into the room. Jason is here!

>give apple to Jason
(first taking the apple)
You offer the apple to Jason and he hesitates. He gingerly takes it out of your hand and then awkwardly hands you his machete. It is very heavy and you almost drop it. Jason silently nods at you and turns to leave. Before walking out the door he turns and flashes the peace sign. Then he is gone.

    *** Nice knife you got there ***

Would you like to RESTART, RESTORE a saved game, QUIT or UNDO the last command?

>restart
Jason's Coming
An Interactive Fiction by Nichtschwert
Release 1 / Serial number 220129 / Inform 7 build 6M62 (I6/v6.33 lib 6/12N) SD

gravity control room
You have locked yourself inside the gravity control room because Jason is coming to murder you. he's breaking down the door right now. Quick! Think of something!

The door to the east is locked. There's nothing but Jason through there.

Affixed to the west wall is a sturdy security case with a lock on it.

A plain-looking desk of dark wood stands in the northeastern corner. It has two drawers.

On the desk are a loaded gun and an apple.

>turn off gravity
You flip the lever and suddenly feel very light. You accidentlaly kick yourself off the floor and bump into the ceiling.
 Jason continues banging on the door. Seems the gravity control only affects this room. very curious.

Jason is beating down the door, but it holds yet.

>shoot door
(first taking the loaded gun)
You fire at the wooden door, punching big holes into it and showering the room with splinters. Was this a good idea?

The door breaks down and is flung into the room. Jason is here!
He looks a bit perplexed as he lifts off the ground entering the room. But he's been in space before. This will not stop him!

>give gun to jason
You offer the loaded gun to Jason and he hesitates. He gingerly takes it out of your hand and then awkwardly hands you his machete. Jason silently nods at you and turns to leave. Before floating out the door he turns and flashes the peace sign. Then he is gone.

    *** Nice knife you got there ***

Would you like to RESTART, RESTORE a saved game, QUIT or UNDO the last command?

* * *

>leave
(first opening the wooden door)
It seems to be locked.

Jason is beating down the door, but it holds yet.

>shoot door
(first taking the loaded gun)
You fire at the wooden door, punching big holes into it and showering the room with splinters. Was this a good idea?

The door breaks down and is flung into the room. Jason is here!

>leave
hallway
Little is left of the door. Could probably just walk on through.

    *** And you walk out. You just walk out. ***

Would you like to RESTART, RESTORE a saved game, QUIT or UNDO the last command?

* * *

>shoot Jason with apple
You can't see any such thing.

>shoot door with apple
(first taking the apple)
You fire at the wooden door, punching big holes into it and showering the room with splinters. Was this a good idea?

The door breaks down and is flung into the room. Jason is here!

* * *

>shoot door with apple
(first taking the apple)
You make pew pew noises while waving the apple around. This impresses nobody.

Jason is beating down the door, but it holds yet.

>shoot door
(first taking the loaded gun)
You fire at the wooden door, punching big holes into it and showering the room with splinters. Was this a good idea?

The door breaks down and is flung into the room. Jason is here!

>shoot Jason with apple
You make pew pew noises while waving the apple around. This impresses nobody.

Jason walks over and hits you with his machete and you die.

    *** The End ***

Would you like to RESTART, RESTORE a saved game, QUIT or UNDO the last command?

>undo
gravity control room
[Previous turn undone.]

>shoot jason
You shoot Jason and he falls over.

You put a couple holes in Jason to little avail.

    *** The End ***

Would you like to RESTART, RESTORE a saved game, QUIT or UNDO the last command?

* * *

>turn off gravity
You flip the lever and suddenly feel very light. You accidentlaly kick yourself off the floor and bump into the ceiling.
 Jason continues banging on the door. Seems the gravity control only affects this room. very curious.
The glass bottle starts floating about ominously. This is not safe.

Jason is beating down the door, but it holds yet.

>flip off gravity
You can't turn gravity any more off than it already is.

Jason continues to beat down the door. It's really starting to come apart.

* * *

>turn off gravity
You flip the lever and suddenly feel very light. You accidentlaly kick yourself off the floor and bump into the ceiling.
 Jason continues banging on the door. Seems the gravity control only affects this room. very curious.
The glass bottle starts floating about ominously. This is not safe.

Jason is beating down the door, but it holds yet.

>turn on gravity
You struggle to flip the lever, but finally manage. Gravity returns much more suddenly than expected and you fall to the floor, landing painfully on your left shoulder.
The glass bottle falls to the floor and shatters into a thousand pieces. This is EXACTLY why we have that security case!

Jason continues to beat down the door. It's really starting to come apart.

>turn off gravity
You turn gravity off again and start floating.

Jason's still hammering away at the door. It's very nearly broken.

>turn on gravity
You turn gravity on again and land deftly on your feet.

The door breaks down and is flung into the room. Jason is here!

* * *

>turn off gravity
You turn gravity off again and start floating.

Jason's still hammering away at the door. It's very nearly broken.

>wait
Time passes.

The door breaks down and is flung into the room. Jason is here!
He looks a bit perplexed as he lifts off the ground entering the room. But he's been in space before. This will not stop him!

>wait
Time passes.

Jason kicks off to float over and murder you. The glass shards in the air shred him to bits before he makes it to you.
Jason floats over and he hits you with his machete and you die.

    *** The End ***

Would you like to RESTART, RESTORE a saved game, QUIT or UNDO the last command?

* * *

>turn on gravity
You struggle to flip the lever, but finally manage. Gravity returns much more suddenly than expected and you fall to the floor, landing painfully on your left shoulder.
The glass bottle falls to the floor and shatters into a thousand pieces. This is EXACTLY why we have that security case!

Jason continues to beat down the door. It's really starting to come apart.

>look
gravity control room
You have locked yourself inside the gravity control room because Jason is coming to murder you. he's breaking down the door right now. Quick! Think of something!

The door to the east is locked. There's nothing but Jason through there.

Affixed to the west wall is a sturdy security case with a lock on it.

You can also see a broken bottle and a desk (on which are a loaded gun and an apple) here.

>x bottle
You see nothing special about the broken bottle.

* * *

>turn off gravity
You flip the lever and suddenly feel very light. You accidentlaly kick yourself off the floor and bump into the ceiling.
 Jason continues banging on the door. Seems the gravity control only affects this room. very curious.
The glass bottle starts floating about ominously. This is not safe.

Jason is beating down the door, but it holds yet.

>shoot gun
(first taking the loaded gun)
The logistics of this mystify me. Try something else!

Jason continues to beat down the door. It's really starting to come apart.

>shoot door
You fire at the wooden door, punching big holes into it and showering the room with splinters. Was this a good idea?

The door breaks down and is flung into the room. Jason is here!
Jason looks a bit perplexed as he lifts off the ground entering the room. But he's been in space before. This will not stop him!

>kiss Jason
Jason might not like that.

Jason walks over and hits you with his machete and you die.

    *** The End ***

Would you like to RESTART, RESTORE a saved game, QUIT or UNDO the last command?

* * *

>turn off gravity
You flip the lever and suddenly feel very light. You accidentlaly kick yourself off the floor and bump into the ceiling.
 Jason continues banging on the door. Seems the gravity control only affects this room. very curious.
The glass bottle starts floating about ominously. This is not safe.

Jason is beating down the door, but it holds yet.

>shoot door
(first taking the loaded gun)
You fire at the wooden door, punching big holes into it and showering the room with splinters. Was this a good idea?

The door breaks down and is flung into the room. Jason is here!
He looks a bit perplexed as he lifts off the ground entering the room. But he's been in space before. This will not stop him!

>turn on gravity
You struggle to flip the lever, but finally manage. Gravity returns much more suddenly than expected and your fall to the floor, landing painfully on your left shoulder.
The glass bottle falls to the floor and shatters into a thousand pieces. This is EXACTLY why we have that security case!
Jason falls and hits his head on the desk, killing him instantly.

    *** It was an accident! ***

Would you like to RESTART, RESTORE a saved game, QUIT or UNDO the last command?

>restart
Jason's Coming
An Interactive Fiction by Nichtschwert
Release 1 / Serial number 220129 / Inform 7 build 6M62 (I6/v6.33 lib 6/12N) SD

gravity control room
You have locked yourself inside the gravity control room because Jason is coming to murder you. he's breaking down the door right now. Quick! Think of something!

The door to the east is locked. There's nothing but Jason through there.

Affixed to the west wall is a sturdy security case with a lock on it.

You can also see a glass bottle and a desk (on which are a loaded gun and an apple) here.

>shoot door
(first taking the loaded gun)
You fire at the wooden door, punching big holes into it and showering the room with splinters. Was this a good idea?

The door breaks down and is flung into the room. Jason is here!

>turn off gravity
You flip the lever and suddenly feel very light. You accidentlaly kick yourself off the floor and bump into the ceiling.
The glass bottle starts floating about ominously. This is not safe.
Jason starts floating off the floor as well, but he seems to quickly adapt. It's as if he's done this before!

Jason floats over and he hits you with his machete and you die.

    *** The End ***

Would you like to RESTART, RESTORE a saved game, QUIT or UNDO the last command?

* * *

>flip off gravity
You flip the lever and suddenly feel very light. You accidentlaly kick yourself off the floor and bump into the ceiling. Jason continues banging on the door. Seems the gravity control only affects this room. very curious.
The glass bottle starts floating about ominously. This is not safe.

Jason is beating down the door, but it holds yet.

* * *

>turn gravity on
You can't turn gravity any more on than it already is.

Jason is beating down the door, but it holds yet.

>undo
gravity control room
[Previous turn undone.]

>turn gravity off
You flip the lever and suddenly feel very light. You accidentlaly kick yourself off the floor and bump into the ceiling. Jason continues banging on the door. Seems the gravity control only affects this room. very curious.
The glass bottle starts floating about ominously. This is not safe.

Jason is beating down the door, but it holds yet.

>turn gravity on
You struggle to flip the lever, but finally manage. Gravity returns much more suddenly than expected and your fall to the floor, landing painfully on your left shoulder.
The glass bottle falls to the floor and shatters into a thousand pieces. This is EXACTLY why we have that security case!

Jason continues to beat down the door. It's really starting to come apart.

>turn gravity off
You turn gravity off again and start floating.
The glass bottle starts floating about ominously. This is not safe.

Jason's still hammering away at the door. It's very nearly broken.

>turn gravity on
You turn gravity on again and land deftly on your feet.
The glass bottle falls to the floor and shatters into a thousand pieces. This is EXACTLY why we have that security case!

The door breaks down and is flung into the room. Jason is here!

* * *

>turn gravity off
You flip the lever and suddenly feel very light. You accidentlaly kick yourself off the floor and bump into the ceiling. Jason continues banging on the door. Seems the gravity control only affects this room. very curious.
The glass bottle starts floating about ominously. This is not safe.

Jason is beating down the door, but it holds yet.

* * *

>turn gravity on
You struggle to flip the lever, but finally manage. Gravity returns much more suddenly than expected and your fall to the floor, landing painfully on your left shoulder.
The glass bottle falls to the floor and shatters into a thousand pieces. This is EXACTLY why we have that security case!

Jason continues to beat down the door. It's really starting to come apart.

>look
gravity control room
You have locked yourself inside the gravity control room because Jason is coming to murder you. he's breaking down the door right now. Quick! Think of something!

The floor is littered with glass shards from the broken bottle.

The door to the east is locked. There's nothing but Jason through there.

Affixed to the west wall is a sturdy security case with a lock on it.

You can also see a desk (on which are a loaded gun and an apple) here.

>turn gravity off
You turn gravity off again and start floating.

Jason's still hammering away at the door. It's very nearly broken.

>look
gravity control room
You have locked yourself inside the gravity control room because Jason is coming to murder you. he's breaking down the door right now. Quick! Think of something!

There are glass shards floating about everywhere! Best not move around too much!

The door to the east is locked. There's nothing but Jason through there.

Affixed to the west wall is a sturdy security case with a lock on it.

You can also see a desk (on which are a loaded gun and an apple) here.

>get bottle
You cut your finger on the glass and think better of it.

The door breaks down and is flung into the room. Jason is here!

>i
You are carrying nothing.

Jason walks over and hits you with his machete and you die.

    *** The End ***

Would you like to RESTART, RESTORE a saved game, QUIT or UNDO the last command?

* * *

>go east
(first opening the wooden door)
It seems to be locked.

Jason is beating down the door, but it holds yet.

>undo
gravity control room
[Previous turn undone.]

* * *

>turn gravity on
You struggle to flip the lever, but finally manage. Gravity returns much more suddenly than expected and your fall to the floor, landing painfully on your left shoulder.
The glass bottle falls to the floor and shatters into a thousand pieces. This is EXACTLY why we have that security case!

Jason continues to beat down the door. It's really starting to come apart.

>turn gravity off
You turn gravity off again and start floating.

Jason's still hammering away at the door. It's very nearly broken.

>e
You try to float your way to the door, but all the glass shrapnel in the air proves to be your undoing.

    *** Seriously. That's why we have the case. ***

Would you like to RESTART, RESTORE a saved game, QUIT or UNDO the last command?

>undo
gravity control room
[Previous turn undone.]

>e
(first opening the wooden door)
It seems to be locked.

Jason's still hammering away at the door. It's very nearly broken.

* * *

>e
(first opening the wooden door)
It seems to be locked.

The door breaks down and is flung into the room. Jason is here!

>e
hallway
Little is left of the door. Could probably just walk on through.

And you walk out. You just walk out.

    *** You have escaped. ***

Would you like to RESTART, RESTORE a saved game, QUIT or UNDO the last command?

* * *

>get bottle
Taken.

Jason is beating down the door, but it holds yet.

>drop bottle
Dropped.

Jason continues to beat down the door. It's really starting to come apart.

>undo
gravity control room
[Previous turn undone.]

>turn off gravity
You flip the lever and suddenly feel very light. You accidentlaly kick yourself off the floor and bump into the ceiling. Jason continues banging on the door. Seems the gravity control only affects this room. very curious.

Jason continues to beat down the door. It's really starting to come apart.

>drop bottle
The bottle starts floating ominously through the room. This is not safe.

Jason's still hammering away at the door. It's very nearly broken.

>turn on gravity
You struggle to flip the lever, but finally manage. Gravity returns much more suddenly than expected and your fall to the floor, landing painfully on your left shoulder.
The glass bottle falls to the floor and shatters into a thousand pieces. This is EXACTLY why we have that security case!

The door breaks down and is flung into the room. Jason is here!

* * *

>get bottle
Taken.

Jason is beating down the door, but it holds yet.

>shoot bottle
(first dropping the glass bottle)
(first taking the loaded gun)
The glass bottle shatters into a thousand pieces. This is EXACTLY why we have that security case!

Jason continues to beat down the door. It's really starting to come apart.

>undo
gravity control room
[Previous turn undone.]

>turn off gravity
You flip the lever and suddenly feel very light. You accidentlaly kick yourself off the floor and bump into the ceiling.
 Jason continues banging on the door. Seems the gravity control only affects this room. very curious.

Jason continues to beat down the door. It's really starting to come apart.

>shoot bottle
(first dropping the glass bottle)The bottle starts floating ominously through the room. This is not safe.

(first taking the loaded gun)
The glass bottle shatters into a thousand pieces which start floating all over the place. This is EXACTLY why we have that security case!

Jason's still hammering away at the door. It's very nearly broken.

>shoot bottle
You put a couple holes in the broken bottle to little avail.

The door breaks down and is flung into the room. Jason is here!
He looks a bit perplexed as he lifts off the ground entering the room. But he's been in space before. This will not stop him!

>shoot jason
You shoot Jason and he falls over.

Yup. Jason's still at it. Will break through any minute now.

    *** You killed him. Rude. ***

Would you like to RESTART, RESTORE a saved game, QUIT or UNDO the last command?

* * *

>turn on gravity
You can't turn gravity any more on than it already is.

Jason is beating down the door, but it holds yet.

>turn off gravity
You flip the lever and suddenly feel very light. You accidentlaly kick yourself off the floor and bump into the ceiling.
 Jason continues banging on the door. Seems the gravity control only affects this room. very curious.
The glass bottle starts floating about ominously. This is not safe.

Jason continues to beat down the door. It's really starting to come apart.

>turn on gravity
You struggle to flip the lever, but finally manage. Gravity returns much more suddenly than expected and you fall to the floor, landing painfully on your left shoulder.
The glass bottle falls to the floor and shatters into a thousand pieces. This is EXACTLY why we have that security case!

Jason's still hammering away at the door. It's very nearly broken.

>turn off gravity
You turn gravity off again and start floating.

The door breaks down and is flung into the room. Jason is here!
He looks a bit perplexed as he lifts off the ground entering the room. But he's been in space before. This will not stop him!

>wait
Time passes.

Jason kicks off to float over and murder you. The glass shards in the air shred him to bits before he makes it to you.

    *** Your irresponsible handling of glass bottles paid off in the end. ***

Would you like to RESTART, RESTORE a saved game, QUIT or UNDO the last command?

>restart
Jason's Coming
An Interactive Fiction by Nichtschwert
Release 1 / Serial number 220129 / Inform 7 build 6M62 (I6/v6.33 lib 6/12N) SD

gravity control room
You have locked yourself inside the gravity control room because Jason is coming to murder you. he's breaking down the door right now. Quick! Think of something!

The door to the east is locked. There's nothing but Jason through there.

Affixed to the west wall is a sturdy security case with a lock on it.

You can also see a glass bottle and a desk (on which are a loaded gun and an apple) here.

>shoot self
(first taking the loaded gun)
You put a couple holes in yourself to little avail.

Jason is beating down the door, but it holds yet.

* * *

>shoot security case
(first taking the loaded gun)
You take a couple shots at the security case but find it frustratingly bulletproof.

Jason is beating down the door, but it holds yet.

>shoot security case with apple
(first taking the apple)
You make pew pew noises while waving the apple around. This impresses nobody.

Jason continues to beat down the door. It's really starting to come apart.

>shoot bottle with bottle
(first taking the glass bottle)
You make pew pew noises while waving the glass bottle around. This impresses nobody.

Jason's still hammering away at the door. It's very nearly broken.

>shoot bottle with gun
(first dropping the glass bottle)
You put a couple holes in the glass bottle to little avail.

The door breaks down and is flung into the room. Jason is here!

* * *

>shoot bottle
The security case isn't open.

Jason is beating down the door, but it holds yet.

* * *

>open drawers
You can't see any such thing.

>open drawer
Which do you mean, the upper drawer or the lower drawer?

>lower
You open the lower drawer, revealing a written note.

Jason is beating down the door, but it holds yet.

>read note
You see nothing special about the written note.

>open upper drawer
You open the upper drawer, revealing a small key.

Jason continues to beat down the door. It's really starting to come apart.

>open case
It seems to be locked.

Jason's still hammering away at the door. It's very nearly broken.

>unlock case
What do you want to unlock the security case with?

>unlock case with key
(first taking the small key)
You unlock the security case.

The door breaks down and is flung into the room. Jason is here!

>throw bottle at jason
The security case isn't open.

Jason walks over and he hits you with his machete and you die.

    *** The End ***

Would you like to RESTART, RESTORE a saved game, QUIT or UNDO the last command?

>restart
Jason's Coming
An Interactive Fiction by Nichtschwert
Release 1 / Serial number 220129 / Inform 7 build 6M62 (I6/v6.33 lib 6/12N) SD

gravity control room
You have locked yourself inside the gravity control room because Jason is coming to murder you. he's breaking down the door right now. Quick! Think of something!

The door to the east is locked. There's nothing but Jason through there.

Affixed to the west wall is a sturdy security case with a lock on it.

A plain-looking desk of dark wood stands in the northeastern corner. It has two drawers.

On the desk are a loaded gun and an apple.

* * *

>open upper drawer
You open the upper drawer, revealing a small key.

Jason is beating down the door, but it holds yet.

>take key
Taken.

Jason continues to beat down the door. It's really starting to come apart.

>unlock case
(with the small key)
You unlock the security case.

Jason's still hammering away at the door. It's very nearly broken.

>open case
You open the security case.

The door breaks down and is flung into the room. Jason is here!

>get bottle
Taken.

Jason walks over and he hits you with his machete and you die.

    *** The End ***

Would you like to RESTART, RESTORE a saved game, QUIT or UNDO the last command?

* * *

>open drawer
Which do you mean, the upper drawer or the lower drawer?

>open upper drawer
You open the upper drawer, revealing a small key.

Jason is beating down the door, but it holds yet.

* * *

>unlock case
(with the small key)
You unlock the security case.

Jason's still hammering away at the door. It's very nearly broken.

>take bottle
The security case isn't open.

Yup. Jason's still at it. Will break through any minute now.

>undo
gravity control room
[Previous turn undone.]

>open case
You open the security case.

Yup. Jason's still at it. Will break through any minute now.

>take bottle
Taken.

Yup. Jason's still at it. Will break through any minute now.

>drop bottle
Dropped.

Yup. Jason's still at it. Will break through any minute now.

>turn off gravity
You flip the lever and suddenly feel very light. You accidentlaly kick yourself off the floor and bump into the ceiling.
 Jason continues banging on the door. Seems the gravity control only affects this room. very curious.
The glass bottle starts floating about ominously. This is not safe.

Yup. Jason's still at it. Will break through any minute now.

>turn on gravity
You struggle to flip the lever, but finally manage. Gravity returns much more suddenly than expected and you fall to the floor, landing painfully on your left shoulder.
The glass bottle falls to the floor and shatters into a thousand pieces. This is EXACTLY why we have that security case!

The door breaks down and is flung into the room. Jason is here!

>turn off gravity
You turn gravity off again and start floating.
Jason starts floating off the floor as well, but he seems to quickly adapt. It's as if he's done this before!

Jason kicks off to float over and murder you. The glass shards in the air shred him to bits before he makes it to you.

    *** Your irresponsible handling of glass bottles paid off in the end. ***

Would you like to RESTART, RESTORE a saved game, QUIT or UNDO the last command?

* * *

>give gun to jason
You can't see any such thing.

>shoot door
(first taking the loaded gun)
You fire at the wooden door, punching big holes into it and showering the room with splinters. Was this a good idea?

The door breaks down and is flung into the room. Jason is here!

>give apple to Jason
(first taking the apple)
lol. lmao. the apple
Jason walks over and he hits you with his machete and you die.

    *** The End ***

Would you like to RESTART, RESTORE a saved game, QUIT or UNDO the last command?

* * *

>switch lever
You switch the gravity control lever off and suddenly feel very light. You accidentlaly kick yourself off the floor and bump into the ceiling.
 Jason continues banging on the door. Seems the gravity control only affects this room. very curious.

Jason is beating down the door, but it holds yet.

>throw lever
The gravity control lever is already here.

Jason is beating down the door, but it holds yet.

>get lever
Taken.

You can hear Jason beating down the door.

* * *

>switch lever
You switch the gravity control lever off and suddenly feel very light. You accidentlaly kick yourself off the floor and bump into the ceiling.
 Jason continues banging on the door. Seems the gravity control only affects this room. very curious.

Jason is beating down the door, but it holds yet.

>switch lever
You struggle to switch the gravity control lever on, but finally manage. Gravity returns much more suddenly than expected and you fall to the floor, landing painfully on your left shoulder.

You can hear Jason beating down the door.

>switch gravity
You turn gravity off again and start floating.

You can hear Jason beating down the door.

>shoot door
(first taking the loaded gun)
You fire at the wooden door, punching big holes into it and showering the room with splinters. Was this a good idea?

The door breaks down and is flung into the room. Jason is here!
He looks a bit perplexed as he lifts off the ground entering the room. But he's been in space before. This will not stop him!

>switch lever
You turn gravity on again and land deftly on your feet.
Jason falls and hits his head on the desk, killing him instantly.

    *** It was an accident! ***

Would you like to RESTART, RESTORE a saved game, QUIT or UNDO the last command?

* * *

>use lever
Try something like TURN OFF GRAVITY or SWITCH GRAVITY ON or TOGGLE GRAVITY

>take lever
That's fixed in place.

Jason is beating down the door, but it holds yet.

>x lever
You see nothing special about the gravity control lever.

>switch gravity
Try something like TURN OFF GRAVITY or SWITCH GRAVITY ON or TOGGLE GRAVITY

* * *

>switch gravity
Try something like TURN OFF GRAVITY or SWITCH GRAVITY ON or TOGGLE GRAVITY

>switch gravity on
Try something like TURN OFF GRAVITY or SWITCH GRAVITY ON or TOGGLE GRAVITY

* * *

>turn on lever
Try something like TURN OFF GRAVITY or SWITCH GRAVITY ON or TOGGLE GRAVITY

* * *

>turn lever
It is fixed in place.

Jason is beating down the door, but it holds yet.

>turn on lever
It isn't something you can switch.

You can hear Jason beating down the door.

>turn on gravity
It isn't something you can switch.

You can hear Jason beating down the door.

* * *

>turn on pistol
You can't see any such thing.

>switch on pistol
You can't see any such thing.

>look
gravity control room
You have locked yourself inside the gravity control room because Jason is coming to murder you. he's breaking down the door right now. Quick! Think of something!

The door to the east is locked. There's nothing but Jason through there.

Affixed to the west wall is a sturdy security case with a lock on it.

A plain-looking desk of dark wood stands in the northeastern corner. It has two drawers.

On the desk are a loaded gun and an apple.

A lever on the southern wall is labelled "gravity control".

>switch on gun
It isn't something you can switch.

Jason is beating down the door, but it holds yet.

>switch on lever
You switch the gravity control lever on.

You can hear Jason beating down the door.

* * *

>switch on lever
You can't turn gravity any more on than it already is.

Jason is beating down the door, but it holds yet.

>switch off lever
That's already off.

You can hear Jason beating down the door.

* * *

>Switch on lever
That's already on.

Jason is beating down the door, but it holds yet.

>Switch off lever
You flip the lever and suddenly feel very light. You accidentlaly kick yourself off the floor and bump into the ceiling.
 Jason continues banging on the door. Seems the gravity control only affects this room. very curious.

You switch the gravity control lever off.

You can hear Jason beating down the door.

* * *

>switch lever off
You flip the lever and suddenly feel very light. You accidentlaly kick yourself off the floor and bump into the ceiling.
 Jason continues banging on the door. Seems the gravity control only affects this room. very curious.

Jason is beating down the door, but it holds yet.

>switch lever on
You struggle to flip the lever, but finally manage. Gravity returns much more suddenly than expected and you fall to the floor, landing painfully on your left shoulder.

You can hear Jason beating down the door.

* * *

>open lower drawer
You open the lower drawer, revealing a written note.

Jason is beating down the door, but it holds yet.

>read note
It simply reads "Jason likes presents".

* * *

>look at case
A sturdy box held on the wall by strong screws. It has a window pane though which you can see a glass bottle. There's a small lock on the case.

In the security case is a glass bottle.

>purloin bottle
(the glass bottle)
[Purloined.]

>look at case
A sturdy box held on the wall by strong screws. It has a window pane. There's a small lock on the case.

* * *

>open upper drawer
You open the upper drawer, revealing a small key.

Jason is beating down the door, but it holds yet.

>get key
Taken.

You can hear Jason beating down the door.

>unlock case
(with the small key)
You unlock the security case.

You can hear Jason beating down the door.

>open case
You open the security case, revealing a glass bottle.

Jason continues to beat down the door. It's really starting to come apart.

>get bottle
You take the hazardous glass bottle out of its security case. Best hold on to it while operating the gravity controls.

You can hear Jason beating down the door.

>drop bottle
Dropped.

You can hear Jason beating down the door.

>get bottle
You take the hazardous glass bottle out of its security case. Best hold on to it while operating the gravity controls.

Jason's still hammering away at the door. It's very nearly broken.

>shoot bottle
(first dropping the glass bottle)
(first taking the loaded gun)
The glass bottle shatters into a thousand pieces. This is EXACTLY why we have that security case!

The door breaks down and is flung into the room. Jason is here!

>turn off gravity
You switch the gravity control lever off and suddenly feel very light. You accidentlaly kick yourself off the floor and bump into the ceiling.
Jason starts floating off the floor as well, but he seems to quickly adapt. It's as if he's done this before!

Jason kicks off to float over and murder you. The glass shards in the air shred him to bits before he makes it to you.

    *** Your irresponsible handling of glass bottles paid off in the end. ***

Would you like to RESTART, RESTORE a saved game, QUIT or UNDO the last command?

* * *

>open upper drawer
You open the upper drawer, revealing a small key.

Jason is beating down the door, but it holds yet.

>unlock case with key
(first taking the small key)
You unlock the security case.

You can hear Jason beating down the door.

>drop bottle
You can't see any such thing.

>undo
gravity control room
[Previous turn undone.]

>open case
You open the security case, revealing a glass bottle.

You can hear Jason beating down the door.

>drop bottle
You haven't got that.

Jason continues to beat down the door. It's really starting to come apart.

>undo
gravity control room
[Previous turn undone.]

>get bottle
You take the hazardous glass bottle. Best hold on to it while operating the gravity controls.

Jason continues to beat down the door. It's really starting to come apart.

>put bottle on table
You can't see any such thing.

>put bottle on desk
You put the glass bottle on the desk.

You can hear Jason beating down the door.

>turn off gravity controls
You can't see any such thing.

>turn off gravity
You switch the gravity control lever off and suddenly feel very light. You accidentlaly kick yourself off the floor and bump into the ceiling.
 Jason continues banging on the door. Seems the gravity control only affects this room. very curious.
The glass bottle starts floating about ominously. This is not safe.

You can hear Jason beating down the door.

>look
gravity control room
You have locked yourself inside the gravity control room because Jason is coming to murder you. He's breaking down the door right now. Quick! Think of something!

The door to the east is locked. There's nothing but Jason through there.

Affixed to the west wall is a sturdy security case with a lock on it.

A plain-looking desk of dark wood stands in the northeastern corner. It has two drawers.

On the desk are a glass bottle, a loaded gun and an apple.

A lever on the southern wall is labelled "gravity control".

* * *

>purloin glass bottle
[Purloined.]

>put glass bottle on desk
You put the glass bottle on the desk.

Jason is beating down the door, but it holds yet.

>turn off gravity
You switch the gravity control lever off and suddenly feel very light. You accidentlaly kick yourself off the floor and bump into the ceiling.
 Jason continues banging on the door. Seems the gravity control only affects this room. very curious.
The glass bottle starts floating about ominously. This is not safe.

You can hear Jason beating down the door.

>look
gravity control room
You have locked yourself inside the gravity control room because Jason is coming to murder you. He's breaking down the door right now. Quick! Think of something!

The door to the east is locked. There's nothing but Jason through there.

Affixed to the west wall is a sturdy security case with a lock on it.

A plain-looking desk of dark wood stands in the northeastern corner. It has two drawers.

On the desk are a loaded gun and an apple.

A lever on the southern wall is labelled "gravity control".

You can also see a glass bottle here.

>turn on gravity
You struggle to switch the gravity control lever on, but finally manage. Gravity returns much more suddenly than expected and you fall to the floor, landing painfully on your left shoulder.
The glass bottle falls to the floor and shatters into a thousand pieces. This is EXACTLY why we have that security case!

You can hear Jason beating down the door.

>turn off gravity
You turn gravity off again and start floating.

Jason continues to beat down the door. It's really starting to come apart.

>shoot door
(first taking the loaded gun)
You fire at the wooden door, punching big holes into it and showering the room with splinters. Was this a good idea?

The door breaks down and is flung into the room. Jason is here!
He looks a bit perplexed as he lifts off the ground entering the room. But he's been in space before. This will not stop him!

>shoot bottle
You put a couple holes in the broken bottle to little avail.

Jason kicks off to float over and murder you. The glass shards in the air shred him to bits before he makes it to you.

    *** Your irresponsible handling of hazardous materials paid off in the end. ***

Would you like to RESTART, RESTORE a saved game, QUIT or UNDO the last command?

>restart
Jason's Coming
An Interactive Fiction by Nichtschwert
Release 1 / Serial number 220129 / Inform 7 build 6M62 (I6/v6.33 lib 6/12N) SD

gravity control room
You have locked yourself inside the gravity control room because Jason is coming to murder you. He's breaking down the door right now. Quick! Think of something!

The door to the east is locked. There's nothing but Jason through there.

Affixed to the west wall is a sturdy security case with a lock on it.

A plain-looking desk of dark wood stands in the northeastern corner. It has two drawers.

On the desk are a loaded gun and an apple.

A lever on the southern wall is labelled "gravity control".

* * *

>open top drawer
You open the upper drawer, revealing a small key.

Jason is beating down the door, but it holds yet.

>get key
Taken.

You can hear Jason beating down the door.

* * *

>open case
You open the security case, revealing a glass bottle.

Jason continues to beat down the door. It's really starting to come apart.

>get bottle
You take the hazardous glass bottle. Best hold on to it while operating the gravity controls.

You can hear Jason beating down the door.

>drop bottle
Dropped.

You can hear Jason beating down the door.

>turn off gravity
You switch the gravity control lever off and suddenly feel very light. You accidentlaly kick yourself off the floor and bump into the ceiling.
 Jason continues banging on the door. Seems the gravity control only affects this room. very curious.
The glass bottle starts floating about ominously. This is not safe.

Jason's still hammering away at the door. It's very nearly broken.

>turn on gravity
You struggle to switch the gravity control lever on, but finally manage. Gravity returns much more suddenly than expected and you fall to the floor, landing painfully on your left shoulder.
The glass bottle falls to the floor and shatters into a thousand pieces. This is EXACTLY why we have that security case!

The door breaks down and is flung into the room. Jason is here!

>turn off gravity
You turn gravity off again and start floating.
Jason starts floating off the floor as well, but he seems to quickly adapt. It's as if he's done this before!

Jason kicks off to float over and murder you. The glass shards in the air shred him to bits before he makes it to you.

    *** Your irresponsible handling of hazardous materials paid off in the end. ***

Would you like to RESTART, RESTORE a saved game, QUIT or UNDO the last command?